NO ./wall.xpm

SO ./wall.xpm







WE 					 ./wall.xpm

C   225,255,25


 EA ./wall.xpm

F           4,4,4









        1111111111111111111111111
        1000000000000000000000001
        10000000000000000000000011
        10010000000000000000000001
1111111110110000010000000000000011
100000000000000000000000000000S1
111101111111110111010000100011111
11110111111111011100000010001
11000000110101011100000010001
10000000000000001100000010001
10000000000000001101010000001
110000011101010111110111100111
11110111 1110101 101111010001
11111111 1111111 111111111111
