NO ./path_to_the_north_texture1

SO ./path_to_the_south_texture2







WE 					 ./path_to_the_west_texture3

C   225,255,25


 EA ../path_to_the_east_texture4

F           255,25,15









        1111111111111111111111111
        1000000000000000000000001
        1011000000000000000000001
        10010000000000000000000001
111111111011000001000000000000001
100000000011000001001000111111111
11110111111111011101000010001
111101111111110111000N0010001
11000000110101011100000010001
10000000000000001100000010001
10000000000000001101010000001
110000011101010111110111100111
11110111 1110101 101111010001
11111111 1111111 111111111111
