C    20,20,0
SO              ./Textures/png/wall.png  



WE					 ./Textures/png/wall.png


EA ./Textures/png/wall.png
NO ./Textures/png/wall.png 

F          50,50,50







111111111111111
10000000000001
1000000000000011111111111
10000001D1000000000000001
1N00000D0D000000010000111
10000001D10000000D00010001
11111111111011111111110001
110000110000001      10001
100000010000001      10001
100000010000001      10001
10000000000000111111111011111111111
10000001000000100000000000000000001
100000010000001000000000000000000011111
110000110000001001110000000000110010001
111111111111111001000000000000010010001
111111111111111111111111111111111111111
