C    20,20,0
SO              ./Textures/png/4.png  



WE					 ./Textures/png/Ground_03.png


EA ./Textures/png/Ground_01.png
NO ./Textures/png/Ground_02.png 

F          50,50,50







111111111111111
10000000000001
1000000000000011111111111
1000000101000000000000001
1N00000000000000010000111
10000001010000000000010001
11111111111011111111110001
110000110000001      10001
100000010000001      10001
100000010000001      10001
10000000000000111111111011111111111
10000001000000100000000000000000001
100000010000001000000000000000000011111
110000110000001001110000000000110010001
111111111111111001000000000000010010001
111111111111111111111111111111111111111
