NO ../Textures/png/wall.png

SO ../Textures/png/wall.png







WE 					 ../Textures/png/wall.png

C   135,206,250


 EA ../Textures/png/wall.png

F           50,50,50








111111111111111
100000000000001
100N000000000011111111111
10000000000000010000000001
1000000000000000000000001
10000000000000000000010001
11111111111011111111110001
110000110000001      10001
100000010000001      10001
100000010000001      10001
10000000000000111111111011111111111
10000001000000100000000000000000001
100000010000001000000000000000000011111
110000110000001001110000000000110010001
111111111111111001000000000000010010001
111111111111111111111111111111111111111
