C    20,20,0
SO ./Textures/png/Ground_01.png



WE ./Textures/png/4.png


EA ./Textures/png/Ground_02.png
NO ./Textures/png/Ground_03.png

F          50,50,50







111111111111111111111111111111
100000000000000000000000000001
100E00000000000000000000000001
100000000000001111111111111111
100000000000000000000000000001
100000010100000000000001000111
100000000000000000100000000001
100000010100000000000000100001
111111111110111111111110000001
110000110000001000000010000001
100000010000001000000010000001
100000010000001000000010000001
100000000000001111111110111111
100000010000001000000000000001
100000010000001000000000000001
110000110000001001110000000001
111111111111111001000000000001
111111111111111111111111111111
