 SO	./Textures/png/Ground_01.png	



WE ./Textures/png/4.png
C    20,20,0

     EA ./Textures/png/Ground_02.png
NO ./Textures/png/Ground_03.png

F          00,00,00  


1

1
1

11 11
10101
10N01
11111
